TTTTTRRRRRRRRRRRRRRTTTTT
TTTTTRRRRRRTTRRRRRRTTTTT
TTTTTRRRRRTTTTRRGRRTTTTT
TTTTTRRRRRTTTTRRRRRTTTTT
TTTTTRRRRRTTTTRRRRRTTTTT
TTTTTXRRRRRTTRRRRRRTTTTT
TTTTTRRRRRTTTTRRRRRTTTTT
TTTTTRRRRRTTTTRRRRRTTTTT
TTTTTRRRRRTTTTRRRRXTTTTT
TTTTTRRRRRTTTTRRRRRTTTTT
TTTTTRRRRRRTTRRRRRRTTTTT
TTTTTXRRRRRTTRRRRRRTTTTT
TTTTTRRRRRTTTTRRRRRTTTTT
TTTTTRRGRRTTTTRRRRRTTTTT
TTTTTRRRRRTTTTRRRRRTTTTT
TTTTTRRRRRRTTRRRRRRTTTTT
TTTTTTRRRRRRRRRRRXTTTTTT
TTTTTTTRRRRRRRRRRTTTTTTT
TTTTTTTTRRRRRRRRTTTTTTTT
TTTTTTTTTRRARRRTTTTTTTTT
