TTTTTTTTT       TTTTTTTT
TTTTTTTT   X      TTTTTT
TTTTTTT            TTTTT
TTTTTT             TTTTT
TTTTTT   G     X   TTTTT
TTTTTTT            TTTTT
TTTTTTTT       J TTTTTTT
TTTTTTTTT       TTTTTTTT
TTTTTTTT         TTTTTTT
TTTTTTT     T     TTTTTT
TTTTTT   X  TT     TTTTT
TTTTTT     TTTT     TTTT
TTTTT        T       TTT
TTTTT             X TTTT
TTTTT               TTTT
TTTTT       X       TTTT
TTTTTT              TTTT
TTTTTTT            TTTTT
TTTTTTTTT         TTTTTT
TTTTTTTTTT   A  TTTTTTTT