TTTTT              TTTTT
TTTTTTTTTB     TTTTTTTTT
TTTTTTTTT      TTTTTTTTT
TTTTT   X          TTTTT
TTTTT      G       TTTTT
TTTTT         X    TTTTT
TTTTTTTTTB     TTTTTTTTT
TTTTTTTTT      TTTTTTTTT
TTTTT  X           TTTTT
TTTTT      N    X  TTTTT
TTTTT  X           TTTTT
TTTTTTTTTB     TTTTTTTTT
TTTTTTTTT      TTTTTTTTT
TTTTT  X           TTTTT
TTTTT      G    J  TTTTT
TTTTT  X           TTTTT
TTTTTTTTT      TTTTTTTTT
TTTTTTTTT      TTTTTTTTT
TTTTT              TTTTT
TTTTT      A       TTTTT
