TTTTTRRRRRRRRRRRRRRTTTTT
TTTTTTTTTBRRRRRTTTTTTTTT
TTTTTTTTTRRRRRRTTTTTTTTT
TTTTTRRRXRRRRRRRRRRTTTTT
TTTTTRRRRRRGRRRRRRRTTTTT
TTTTTRRRRRRRRRXRRRRTTTTT
TTTTTTTTTBRRRRRTTTTTTTTT
TTTTTTTTTRRRRRRTTTTTTTTT
TTTTTRRXRRRRRRRRRRRTTTTT
TTTTTRRRRRRNRRRRXRRTTTTT
TTTTTRRXRRRRRRRRRRRTTTTT
TTTTTTTTTBRRRRRTTTTTTTTT
TTTTTTTTTRRRRRRTTTTTTTTT
TTTTTRRXRRRRRRRRRRRTTTTT
TTTTTRRRRRRGRRRRJRRTTTTT
TTTTTRRXRRRRRRRRRRRTTTTT
TTTTTTTTTRRRRRRTTTTTTTTT
TTTTTTTTTRRRRRRTTTTTTTTT
TTTTTRRRRRRRRRRRRRRTTTTT
TTTTTRRRRRRARRRRRRRTTTTT
