TTTTTTTTTRRRRRRRTTTTTTTT
TTTTTTTTRRRXRRRRRRTTTTTT
TTTTTTTRRRRRRRRRRRRTTTTT
TTTTTTRRRRRRRRRRRRRTTTTT
TTTTTTRRRRRRRRRXRRRTTTTT
TTTTTTTRRRRRRRRRRRRTTTTT
TTTTTTTTRRRRRRRRRTTTTTTT
TTTTTTTTTRRRRRRRTTTTTTTT
TTTTTTTTTRRRTRRRRTTTTTTT
TTTTTTTRRRRRTTTRRRTTTTTT
TTTTTTRRRXRTTTTTTRRTTTTT
TTTTTTRRRRTTTTTTTRRRTTTT
TTTTTRRRRRRRTTTTRRRRRTTT
TTTTTRRRRRRRRRRRRRXRTTTT
TTTTTRRRRRRRRRRRRRRRTTTT
TTTTTRRRRRRRXRRRRRRRTTTT
TTTTTTRRRRRRRRRRRRRRTTTT
TTTTTTTRRRRRRRRRRRRTTTTT
TTTTTTTTTRRRRRRRRRTTTTTT
TTTTTTTTTTRRRARRTTTTTTTT