TTTTTTTTTRRRRRRRTTTTTTTT
TTTTTTTTRRRXRRRRRRTTTTTT
TTTTTTTRRRRRRRRRRRRTTTTT
TTTTTTRRRRRRRRRRRRRTTTTT
TTTTTTRRRGRRRRRXRRRTTTTT
TTTTTTTRRRRRRRRRRRRTTTTT
TTTTTTTTRRRRRRRJRTTTTTTT
TTTTTTTTTRRRRRRRTTTTTTTT
TTTTTTTTRRRRRRRRRTTTTTTT
TTTTTTTRRRRRTRRRRRTTTTTT
TTTTTTRRRXRRTTRRRRRTTTTT
TTTTTTRRRRRTTTTRRRRRTTTT
TTTTTRRRRRRRRTRRRRRRRTTT
TTTTTRRRRRRRRRRRRRXRTTTT
TTTTTRRRRRRRRRRRRRRRTTTT
TTTTTRRRRRRRXRRRRRRRTTTT
TTTTTTRRRRRRRRRRRRRRTTTT
TTTTTTTRRRRRRRRRRRRTTTTT
TTTTTTTTTRRRRRRRRRTTTTTT
TTTTTTTTTTRRRARRTTTTTTTT