TTTTTTTTRRRRRRRRRRRTTTTT
TTTTTTTRRRRNRRRRRRRTTTTT
THTTTTRRRRRRRRRRRRRTTTTT
TTTTTTTRRRRRRRGRRRRTTTTT
TTTTTTTTRRRRRRJRRRRTTTTT
TTTTTTTTTRRRRRRRRRRTTTTT
TTTTTTTTTTRRRRRNRRRTTTTT
TTTTTTTTTTTRRRRRRRRTTTTT
TTTTTTTTTTTTRRRRRRRTTTTT
TTTTTTTTTTTTTRRRRRRTTTTT
HTTTSSSSSSSHTTRRXRRTTTTT
TTTTTTTTTTTTTRRRRRRTTTTT
TTTTTTTTTTTTRRRRRRRTTTTT
TTTTTTTTTTTRRRRRRRRTTTTT
TTTTTTTTTTRRRRRRRRRTTTTT
TTTTTTTTTRRRRRJRRRRTTTTT
TTHTTTTTRRRRRRRRRRRTTTTT
TTTTTTTRRRRRRGRRRRRTTTTT
TTTTTTRRRRRRRRRRRRRTTTTT
TTTTTRRRRRRRARRRRRRTTTTT