TTTTT              TTTTT
TTTTTTTTTP     TTTTTTTTT
TTTTTTTTT      TTTTTTTTT
TTTTT   X          TTTTT
TTTTT      G       TTTTT
TTTTT         X    TTTTT
TTTTTTTTTP     TTTTTTTTT
TTTTTTTTT      TTTTTTTTT
TTTTT  X           TTTTT
TTTTT      N    X  TTTTT
TTTTT  X           TTTTT
TTTTTTTTTP     TTTTTTTTT
TTTTTTTTT      TTTTTTTTT
TTTTT  X           TTTTT
TTTTT      G    J  TTTTT
TTTTT  X           TTTTT
TTTTTTTTT      TTTTTTTTT
TTTTTTTTT      TTTTTTTTT
TTTTT              TTTTT
TTTTT      A       TTTTT
