TTTTT              TTTTT
TTTTT      TT      TTTTT
TTTTT     TTTT  G  TTTTT
TTTTT     TTTT     TTTTT
TTTTT     TTTT     TTTTT
TTTTTX    TTTT     TTTTT
TTTTT     TTTT     TTTTT
TTTTT     TTTT     TTTTT
TTTTT     TTTT    XTTTTT
TTTTT     TTTT     TTTTT
TTTTT      TT      TTTTT
TTTTTX     TT      TTTTT
TTTTT     TTTT     TTTTT
TTTTT  G  TTTT     TTTTT
TTTTT     TTTT     TTTTT
TTTTT      TT      TTTTT
TTTTTT           XTTTTTT
TTTTTTT          TTTTTTT
TTTTTTTT        TTTTTTTT
TTTTTTTTT  A   TTTTTTTTT
