TTTTTRRRRRRRRRRRRRRTTTTT
TTTTTTRRRRNRRRRRRRTTTTTT
TTHTTRRRRRRRRRRRRRRTTTTT
TTTTTTRRJRRRRRRRRRTTTTTT
TTTTTRRRRRRRRRRGRRRTTTTT
TTTTTTRRRRRRRRRRRJTTTTTT
TTTTTRRRRRRRRRRRRRRTTTTT
TTTTTTRRJRRRRRRRRRTTTHTT
TTTTTRRRGRRRRRRRRRRTTTTT
TTTTTTRRRRRRRRRRRJTTTTTT
TTTTTRRRRRRRRRRRRRRTTTTT
TTTTTTRRJRRRRRRRRRTTTTTT
TTTTTRRRRRRRRRRRRRRTTTTT
TTTTTRRRRRRRRRRRRRJTTTTT
TTTTTTTTTBRRRRRTTTTTTTTT
TTTTTTTTTRRRRRRTTTTTTHTT
TTTTTTTTRRRRRRRRTTTTTTTT
TTHTTTTRRRRRRRRRRTTTTTTT
TTTTTTRRRRGRRRRRRRTTTTTT
TTTTTRRRRRRARRRRRRRTTTTT