TTTTTTTTTRRRRRRRTTTTTTTT
TTTTTTTTRRRXRRRRRRTTTTTT
TTTTTTTRRRRRRRRRRRRTTTTT
TTTTTTRRRRRRRRRRRRRTTTTT
TTTTTTRRRGRRRRRXRRRTTTTT
TTTTTTTRRRRRRRRRRRRTTTTT
TTTTTTTTRRRRRRRJRTTTTTTT
TTTTTTTTTRRRRRRRTTTTTTTT
TTTTTTTTTNRRTRRRRTTTTTTT
TTTTTTTRRRRRTTTRRRTTTTTT
TTTTTTRRRXRTTTTTTRRTTTTT
TTTTTTRRRRTTTTTTTRRRTTTT
TTTTTRRRRRRRTTTTRRRRRTTT
TTTTTRRRRRRRRRRRRRXRTTTT
TTTTTRRRRRRRRRRRRRRRTTTT
TTTTTRRRRRRRXRRRRRRRTTTT
TTTTTTRRRRRRRRRRRRRRTTTT
TTTTTTTRRRRRRRRRRRRTTTTT
TTTTTTTTTRRRRRRRRRTTTTTT
TTTTTTTTTTRRRARRTTTTTTTT