TTTTT              TTTTT
TTTTTT    N       TTTTTT
TTHTT              TTTTT
TTTTTT  J         TTTTTT
TTTTT          G   TTTTT
TTTTTT           JTTTTTT
TTTTT              TTTTT
TTTTTT  J         TTTHTT
TTTTT   G          TTTTT
TTTTTT           JTTTTTT
TTTTT              TTTTT
TTTTTT  J         TTTTTT
TTTTT              TTTTT
TTTTT             JTTTTT
TTTTTTTTTP     TTTTTTTTT
TTTTTTTTT      TTTTTTHTT
TTTTTTTT        TTTTTTTT
TTHTTTT          TTTTTTT
TTTTTT    G       TTTTTT
TTTTT      A       TTTTT