TTTTTTTT           TTTTT
TTTTTTT    N       TTTTT
THTTTT             TTTTT
TTTTTTT       G    TTTTT
TTTTTTTT      J    TTTTT
TTTTTTTTT          TTTTT
TTTTTTTTTT     N   TTTTT
TTTTTTTTTTT        TTTTT
TTTTTTTTTTTT       TTTTT
TTTTTTTTTTTTT      TTTTT
HTTTSSSSSSHTTT  X  TTTTT
TTTTTTTTTTTTT      TTTTT
TTTTTTTTTTTT       TTTTT
TTTTTTTTTTT        TTTTT
TTTTTTTTTT         TTTTT
TTTTTTTTT     J    TTTTT
TTHTTTTT           TTTTT
TTTTTTT      G     TTTTT
TTTTTT             TTTTT
TTTTT       A      TTTTT